000000000000000000000000000000000000000000000000000000000000000000000000000000000000000000000000000000000000000000000000000000000000000000000000000000000000000000000000000000000000000000000000000000000000000000000000000000000000000000000000
000000000000000000000000000000000000000000000000000000000000000000000000000000000000000000000000000000000000000000000000000000000000000000000000000000000000000000000000000000000000000000000000000000000000000000000000000000000000000000000000
000000000000000000000000000000000000000000000000000000000000000000000000000000000000000000000000000000000000000000000000000000000000000000000000000000000000000000000000000000000000000000000000000000000000000000000000000000000000000000000000
000000000000000000000000000000000000000000000000000000000000000000000000000000000000000000000000000000000000000000000000000000000000000000000000000000000000000000000000000000000000000000000000000000000000000000000000000000000000000000000000
000000000000000000000000000000000000000000000000000000000000000000000000000000000000000000000000000000000000000000000000000000000000000000000000000000000000000000000000000000000000000000000000000000000000000000000000000000000000000000000000
000000000000000000000000000000000000000000000000000000000000000000000000000000000000000000000000000000000000000000000000000000000000000000000000000000000000000000000000000000000000000000000000000000000000000000000000000000000000000000000000
000000000000000000000000000000000000000000000000000000000000000000000000000000000000000000000000000000000000000000000000000000000000000000000000000000000000000000000000000000000000000000000000000000000000000000000000000000000000000000000000
000000000000000000000000000000000000000000000000000000000000000000000000000000000000000000000000000000000000000000000000000000000000000000000000000000000000000000000000000000000000000000000000000000000000000000000000000000000000000000000000
000000000000000000000000000000000000000000000000000000000000000000000000000000000000000000000000000000000000000000000000000000000000000000000000000000000000000000000000000000000000000000000000000000000000000000000000000000000000000000000000
000000000000000000000000000000000000000000000000000000000000000000000000000000000000000000000000000000000000000000000000000000000000000000000000000000000000000000000000000000000000000000000000000000000000000000000000000000000000000000000000
000000000000000000000000000000000000000000000000000000000000000000000000000000000000000000000000000000000000000000000000000000000000000000000000000000000000000000000000000000000000000000000000000000000000000000000000000000000000000000000000
000000000000000000000000000000000000000004002002002002002008000000000000000000000000000000000000000000000000000000000000000000000000000000000000000000000000000000000000000000000000000000000000000000000000000000000000000000000000000000000000
000000000000000004002002002008000000000009006006006006006013000000000000000000000000000000000000000000000000000000000000000000000000000000000000000000000000000000000000000000000000000000000000000000000000000000000000000000000000000000000000
000000000000000009006006006013000000000009006006006006006013000000000000000000000000000000000000000000000000000000000000000000000000000000000000000000000000000000000000000000000000000000000000000000000000000000000000000000000000000000000000
002002002002002005006006006007002002002005006006006006006007002002002002002002002002002002002002002002002002002002002002002002002002002002002002002002002002002002002002002002002002002002002002002002002002002002002002002002002002002002002002
006006006006006006006006006006006006006006006006006006006006006006006006006006006006006006006006006006006006006006006006006006006006006006006006006006006006006006006006006006006006006006006006006006006006006006006006006006006006006006006006
006006006006006006006006006006006006006006006006006006006006006006006006006006006006006006006006006006006006006006006006006006006006006006006006006006006006006006006006006006006006006006006006006006006006006006006006006006006006006006006006
006006006006006006006006006006006006006006006006006006006006006006006006006006006006006006006006006006006006006006006006006006006006006006006006006006006006006006006006006006006006006006006006006006006006006006006006006006006006006006006006
006006006006006006006006006006006006006006006006006006006006006006006006006006006006006006006006006006006006006006006006006006006006006006006006006006006006006006006006006006006006006006006006006006006006006006006006006006006006006006006006
006006006006006006006006006006006006006006006006006006006006006006006006006006006006006006006006006006006006006006006006006006006006006006006006006006006006006006006006006006006006006006006006006006006006006006006006006006006006006006006006
006006006006006006006006006006006006006006006006006006006006006006006006006006006006006006006006006006006006006006006006006006006006006006006006006006006006006006006006006006006006006006006006006006006006006006006006006006006006006006006006
006006006006006006006006006006006006006006006006006006006006006006006006006006006006006006006006006006006006006006006006006006006006006006006006006006006006006006006006006006006006006006006006006006006006006006006006006006006006006006006006
006006006006006006006006006006006006006006006006006006006006006006006006006006006006006006006006006006006006006006006006006006006006006006006006006006006006006006006006006006006006006006006006006006006006006006006006006006006006006006006006
006006006006006006006006006006006006006006006006006006006006006006006006006006006006006006006006006006006006006006006006006006006006006006006006006006006006006006006006006006006006006006006006006006006006006006006006006006006006006006006006
006006006006006006006006006006006006006006006006006006006006006006006006006006006006006006006006006006006006006006006006006006006006006006006006006006006006006006006006006006006006006006006006006006006006006006006006006006006006006006006006
006006006006006006006006006006006006006006006006006006006006006006006006006006006006006006006006006006006006006006006006006006006006006006006006006006006006006006006006006006006006006006006006006006006006006006006006006006006006006006006006
006006006006006006006006006006006006006006006006006006006006006006006006006006006006006006006006006006006006006006006006006006006006006006006006006006006006006006006006006006006006006006006006006006006006006006006006006006006006006006006006
006006006006006006006006006006006006006006006006006006006006006006006006006006006006006006006006006006006006006006006006006006006006006006006006006006006006006006006006006006006006006006006006006006006006006006006006006006006006006006006006